-1 -1 -1 -1 -1 -1 -1 -1 -1
-1 -1 -1 -1 18 15 -1 -1 -1
-1 -1 -1 0 -1 14 -1 -1 -1
-1 -1 -1 1 -1 13 12 -1 -1
-1 17 16 2 5 -1 11 -1 -1
-1 19 -1 3 4 6 7 10 -1
-1 20 -1 -1 -1 -1 8 -1 -1
-1 -1 -1 -1 -1 -1 9 -1 -1
-1 -1 -1 -1 -1 -1 -1 -1 -1
